# # # # # # # # # #
# . # . . . . . . #
# . # . # # # # . #  
# . # . . . . # . #
# . # # # # . # . #
# . . . . . . # . #
# # # # # # . # . #
# . . . . . . # . #
# . # # # # # # . #
# . . . . . . . . #
# # # # # # # # # #
